{
  "0": ["A", "I", "R", "W"],
  "1": ["J", "K", "P", "T"],
  "2": ["C", "E", "M", "X"],
  "3": ["B", "H", "Q", "U"],
  "4": ["O", "V", "Y"],
  "5": ["F", "G", "L", "Z"],
  "6": ["D", "N", "S"]
}